11111111111111
100011100000C1
10P01C00111101
1000000011C101
10010000000001
10100000111101
1101C0001C0001
11111011111101
10010011000001
1C010000011101
110C0111C111E1
11111111111111
